#######
#@.D.<#
#..#..#
#..#..#
#....##
#.#..>#
#######
