theme: bricks
#######
#@.D.<#
#.g#..#
#..#..#
#...o##
#.#..>#
#######
